*************
*.........*.*
*.***.***.*.*
*...*...*.*.*
***.*.***.*.*
*...*.....*.*
*.*******.*.*
*.......*...*
*.*****.*.***
*.*...*.*...*
*.*.*.*.*.*.*
*...*...*.*.*
***.*.***.*.*
*...*.....*.*
*.*******.*.*
*.......*...*
*.*******.*.*
*...*.....*.*
***.*.***.*.*
*...*...*.*.*
*.*******.*.*
*.........*.*
*************